yll: cup zvv huu
aqb: ull bit eih
tyk: yfr
mjg: qnm
tev: fft dbl gkj rzj
tpv: dmr fwn
fxx: bsu gmk kdr fqh
sou: axj
xdg: fqh
ntd: zgj eje tcc ygr
tya: rqt vbf
irn: out
dvq: rpr
hcq: nvt
jgx: fqh ntd
rpr: rqt xgi vbf mfw zal
mel: ait azs you
qaf: mie sdb vja
ldu: pjc slf
iqa: hei
lwl: eqv ewu
rqt: nbu tpv fdx fmw tot mpz sda qkv gkr hmr ghl hfi hyn flo qou jwi rsw jwm dkt
ibr: jei
xao: saz mxi
tvh: obi jei rmr
xyb: fri
kaq: out
ocz: wts jyv iup
yfr: knl wdm pmw
udm: owp xhb
cpv: rpg muu sgn eyb bbp
ozt: kei
tmr: mca ema
puh: ibv vjw
yyk: uzy hkj
jbg: qnb
gdd: wen ojn jrw vti
fgk: lix kaq
wco: emp qll
gvd: yll obc
vhf: twf oam tzg mej
xrs: ndo ydo bwh
uzy: njr zee auy yoy sgw uef yji xdg jgx gcx ouk kfp
hxe: plu hgq qdm vfu
lxc: nlz pjh
gkr: jwc fsk rhq hxe
fmd: rct htn iqz vht
igz: oam tfm twf tzg mej
ywu: wts kiv jyv xpi iup
icx: brt rkg
fib: sin
fhq: hbi
mzo: mfh
jqo: akj vqp
iqs: swf ocz
idq: mgc jzo gxs fhn
dyk: kfo wzi nwo dbf
tkx: dlw cpv
huu: out
fwn: irc lln ood
rvv: jbo sss
nlz: out
tot: fwn dmr xsn
coj: wfa jnx une
sub: hcc vqi
uet: lwa
uab: qll
vqi: wts kiv iup xpi
knl: uhf
gkj: hyv kzs ikf sms
sss: chv
pul: jsv vwr
ggp: sdm
fri: out
ogi: ajw ntl qme
iwv: djb iyu vqm hzj
wey: cxq
czo: stq
yqi: fqp xba hgv aea mhg
xip: azs you
fsk: vfu
epo: nfy ymg
fdd: iwt stq
vsa: out
jdt: ntl ajw
zvi: hgk mel jrd xip
nup: fhq nvt
zvv: out
mhy: kla ldu
rzj: ikf hyv
iyu: vbf
rmp: bqy
mjl: oqr elj lww
yki: xqm zsd
uig: vbf mfw
jrw: xha uig
nop: zpd fgz
ebl: ibh zaq
npl: emp
byi: mjl ffk
cng: blm
gmk: lpf
clu: wzd jnx wfa
mea: wag
fdx: zvm krf
gwm: vdj
jsv: mfw zal xgi rqt
qlf: rpr tfd etk
zsd: ska
cbp: xlv
bti: dyk whx
oam: out
pwa: mfh
aci: taj izb
opz: dwm swg
uqd: vwi txg
hqv: emp mfh
sms: hkj uzy dny
abi: saz
qry: gdd pwo ihu
ait: qxa vnl dqn thp cbe scz gjw lpu hyb igc vvx dek tkx rmp aqb mhy
uoa: zds qnm nhm ouo
rkg: out
cxq: mxa zbx jeu
fqh: tcc zgj lpf
xin: vbz fnl ngb bwk pnm lqh qaf ldm rvv goe
yng: ptr wcq
ldm: osx
hfi: xsn dmr
ykf: xyb fgk nzm
txr: bdt
mca: oqr
ull: jdt zcj
oac: azs you ait
jdu: hmk vwe
ffk: oqr elj lww
wdm: dny uhf
bba: pwo gdd txr
ikf: hkj uzy
mxi: yuo ttd
jyi: uhf hkj
zal: mpz tot uht rsw
ftt: mfw rqt xgi
oim: mjg gfk uoa aqj
gjw: ziz
lww: azs
sin: out
fnl: sdb
boh: xzo xao vtg
mhb: kqf fyr
kzs: uhf dny uzy hkj
wlg: ggp slf pjc nkj
xsi: dyk gby uym
kou: azs ait
ziz: hcv czo pno
swg: kou tmc qjr
ska: out
chv: emp mfh
wei: uyk iwt stq
dkt: fsk
dny: gcx jgx xdg xrs kfp ouk zee ual njr bba wxc lcp uef sgw yoy auy
dwg: brt nlz pjh
anf: onh
qgz: sqe
dsi: vwe tyk
gkc: vwi qnp oim txg
iqz: uzy dny
zbx: qll mfh
zds: uzy
uht: yxo jmm roz
fhn: dbl rzj gkj jlh
nfy: azs
mhg: fmd aqu
saa: out
twf: out
owp: nkx nyp
amj: cbt
dfp: mcq
htn: uhf dny
izb: jyv wts kiv
ioi: gwm ngb kfg ldm bwk pay vbz
cru: dny
rqj: out
wxc: ffz ihu gdd
wen: xha uig
you: gjw rmp vnl qxa vvx dek boh aqb
iup: vep clu byi yxz fln coj arv tmr amj dpg lox inl iqc opz tlw cwg kno ida
gvq: khf jts idy
kqf: azs you
vil: axn hqv jcb
njr: pvx hzb sbn kyp
qnm: hkj
lsw: fzk igh udm
ckr: vqi
zgj: mre dfx dpy
jyv: ljb kno ida amj lox dpg clu byi opz
syx: tqk owp bpk
nzm: fri lix
jne: hgv xba fqp mhg aea
lix: out
bpk: nkx nyp kqt
blm: xbo rug vbg bgl
jnl: kei cwr xxc
obu: hkj uzy dny uhf
ood: ywu def kaw
rmr: yhi
ouo: hkj dny uzy
fqp: otm fmd
azs: dqn boh qgz thp cbe mhy hyb lpu gjw vvx rmp
hcc: wts xpi
ezf: emj epo wag
ohf: dyk
ywt: vhf yqk czj igz
etk: rqt xgi vbf zal mfw
hyn: zmv gvq
wxy: out
tzg: out
ajw: xuz fib ngw
jwc: hgq vfu
tfm: out
lwa: mxa zbx qqs uab
qlk: kqf
bkm: aea mhg
pnm: ewu eqv
xpo: qlf dvq rzf
eqv: xbo qmn bgl
gql: brt rkg axj
mer: rmr obi
pay: vja mie
mie: pmc qsg
xzo: mxi xtu
bjj: sss osx jbo
hox: jqr zpd fgz
ntl: ngw
skt: vbf zal mfw xgi
hei: zbx qqs jeu uab
lln: def ywu
gnm: jqr fgz
dna: jcb axn
cyn: uym gby whx
ymg: ait
xsn: irc lln
nhm: hkj uzy dny uhf
nwo: fgk
kyp: pul evh
eih: onj zcj ogi
ibh: mhb cbp ikr
nat: ame xpo
mqe: mfh
qqs: mfh qll emp
rug: dna vlm
zpd: uyp uvi
zmv: jts idy
wzd: mea ezf
hzb: evh xet
ygr: dpy iwv dfx mre
thp: uxd cpv
pew: syx sqq fzk igh
vwi: aqj mjg gfk
yuo: czj yqk
xet: tya skt jsv
yqk: oam tfm mej tzg
vnl: bgy ziz bqy
emp: ysc dsi jdu jne huj gvm wrm idq uqd gkc
vja: qsg kao wco mzo pmc
jpk: zaq
mre: vqm hzj iyu
sgw: nup xho anf
vwr: mfw vbf xgi rqt
une: tet dac ezf
nhl: tmc qjr uhx
hbi: kei cwr
xqm: irn
swf: wts iup xpi
brt: out
fpz: vai
sid: jyi wtr
vqp: ska rqj
xxc: xgi vbf zal
jcb: mfh emp
uhx: you azs
roz: sub
tcc: dsb dpy iwv dfx
svr: oll yco ioi xin kqo
fsj: kqf xlv
pkr: ymg
tyx: xgi rqt zal vbf
hmr: fsk jwc hxe hnl
sdb: qsg mzo
pmw: hkj uzy
emj: ymg oac nfy
mgc: fft gkj
ttd: igz czj yqk vhf
axn: emp qll
igh: owp tqk
ekl: mfh emp qll
ewu: bgl vbg xbo rug
fyr: ait
mgq: fhq onh
der: xgi rqt
kdr: zgj ygr tcc
ysc: fzk sqq
goe: lly vdj puh
vht: hkj uzy
rzf: tyx tfd
qnb: ikr fsj mhb
uyp: ptr vai qtz kge
bqy: czo hcv wei
eyb: jqo
ljb: vum
uvi: wcq qtz vai
gcx: nup hcq
vjw: oxe wrb
dxy: uab jeu zbx mxa
jqr: uyp uvi ujt
cwg: dwm
dqc: you
hyv: hkj uzy dny
nvt: hhp jnl fxi ozt hbi
dwm: uhx
djb: zal xgi rqt
fln: ose ebl jbg vyb jpk
dpy: djb
uhf: bba njr ual zee yoy sgw yji wxc qry fxx kfp lgq
hhp: xxc
fmw: xsn
yco: cng fnl vbz rvv qaf wkh lqh ngb kfg lwl goe ldm
xpi: ida kno tlw opz iqc inl lox arv coj fln yxz clu vep
mej: out
dlw: eyb bbp sgn muu rpg
pjc: dfp
arv: fvq
stq: dwg sou
bsu: eje
qou: hox nop ytc
fgz: uyp fpz yng
gfk: zds nhm
vwe: qci eai
bbp: xgm
npn: eom
ual: anf
pxm: lix fri
pno: stq
kfp: nat
oqr: azs you ait
ouk: ydo dnk bwh
qnp: uoa aqj gfk
vai: kiv wts xpi
dek: kla wlg ltx
yhi: sid tri vxj rae
cup: out
hgk: ait azs
xho: fhq
akg: vqi hcc
tmu: kiv wts xpi
cnn: idy khf
qjr: ait you azs
rmx: icx sou
bwh: lli
xgi: flo qou dkt sda fdx ghl hfi
rhq: qdm hgq plu
jnx: ezf mea tet
huj: udm fzk igh sqq
ikr: xlv
lpf: dsb
gby: wzi dbf
kaw: iup xpi kiv
buz: oim qnp
xha: xgi zal
ihu: jrw vti ojn
jmm: ckr ncb akg sub npn
kge: xpi kiv jyv
gxs: dbl jlh
cbe: xzo abi
vcc: dyk
hdx: akj
jei: xoe yhi qvq
qdm: kiv wts iup xpi
osx: iwp tvf
aea: fmd aqu
irq: fhn jzo gxs tev mgc
mxa: emp
rmm: ocz taj izb swf
wrm: hmk
vlm: hqv jcb ekl
uxd: rpg muu eyb bbp
bwk: sss osx
onh: fxi jnl
nbu: fwn
qme: fib
lox: ema mjl mca
bgl: vil vlm qdx mok
yji: kdr fqh gmk
tqk: nkx kqt
oqc: tmc
ydo: lli
slf: gvd
pmc: qll mfh
vbg: qdx mok vlm vil
jwm: hox nop gnm ytc
plu: iup xpi jyv
tvf: emp qll mfh
akj: wxy irn
kno: ebl ose vyb jpk
rae: wtr jyi cru
vqm: xgi
pjh: out
obc: huu muv cup
dbf: xyb
txg: uoa
ose: zaq
ngw: saa vsa
ftu: hmk
lgq: bsu fqh
muu: yki xgm jqo
vyb: zaq ibh qnb
ury: uet wey iqa
mok: ekl hqv
xtu: ttd ucw yuo
ida: fvq
tet: epo emj
sqe: pjc wps slf
qsg: mfh emp
hyb: cpv dlw
yxo: ckr npn
rsw: ytc
mpz: roz yxo krf zvm jmm
mfw: qkv uht ghl fdx jwm nbu
kqt: bmc sjx
wfa: ezf dac mea tet
cbt: elj oqr
uef: hzb sbn kyp
auy: mgq hcq anf
vhx: mfh emp qll
hzj: mfw zal xgi
dfx: djb vqm hzj
ghl: cnn gvq zmv
exl: tyk
wag: oac ymg nfy dqc
vum: jrd xip hgk mel
ngb: blm eqv ewu
fbn: vja
dpg: fvq zvi vum
jrd: ait
pvx: evh
zaq: cbp fsj ikr qlk
dmr: lln
lly: rkq
wtr: uhf uzy dny
dac: pkr emj
xba: fmd
ltx: pjc
kao: mfh qll emp
tmc: ait you azs
oxe: pwa sqf
aqu: vht iqz htn
jlh: sms ikf kzs hyv
qkv: gnm hox
sgn: jqo xgm yki hdx
hgq: kiv iup
sqf: qll
rpg: xgm yki hdx
hgv: otm
kqo: lqh bjj fbn ury
zcj: ajw ntl
obi: qvq
ojn: ftt uig
wkh: wey uet sxk
zvm: npn
gvm: mgc jzo gxs
igc: xao vtg abi
ytc: jqr
pmh: sqq syx udm
aqj: zds ouo qnm
lcp: ndo ydo dnk
jbo: tvf npl
lqh: wey iqa uet
evh: vwr tya skt jsv
fzk: tqk xhb bpk
yxz: dwm oqc swg nhl
qxa: bit
qll: pew jne tvh irq idq ibr dsi exl pmh ftu ysc bkm mer
sda: zmv
ibv: wrb oxe bjd
muv: out
uyk: gql icx lxc
vbf: jwi qou flo hyn jwm rsw dkt tpv nbu fmw fdx sda mpz hfi ghl hmr uht gkr qkv
sdm: yll obc mcq
vep: fvq
kla: nkj pjc slf ggp
sxk: hei lwa dxy
krf: akg
qmn: vil vlm mok
oll: lwl wkh goe cnl
sbn: pul evh xet
fvq: jrd xip hgk mel
ffz: bdt vti wen ojn
kei: vbf mfw zal rqt xgi
vdj: rkq vjw
lpu: xsi ohf
eje: dsb dfx iwv mre
sqq: tqk
vtg: saz xtu mxi
dnk: xpo ame
zee: kyp sbn pvx
axj: out
rkq: bjd oxe
inl: wzd une jnx wfa
ncb: vqi hcc
idy: aci iqs
otm: htn rct iqz
xgm: vqp zsd
yoy: hcq mgq anf nup
xuz: sin saa vsa
rct: dny uzy
hnl: plu hgq vfu
dsb: der
mcq: muv cup zvv
ema: elj
bdt: xha
fft: sms yyk kzs ikf
xxd: hkj dny uzy uhf
fxi: xxc
hkj: lgq xrs wxc ouk yoy gcx qry jgx fxx ual njr bba
qdx: axn
ujt: qtz wcq ptr vai
tfd: vbf rqt
vfu: kiv wts
xhb: nyp nkx
jwi: gvq
wps: sdm
ndo: xpo
scz: xsi ohf bti cyn vcc
wzi: nzm pxm
kiv: dpg lox iqc inl tlw opz kno byi yxz ljb fln
nkj: gvd dfp sdm
bmc: uhf hkj
xlv: ait you
ucw: vhf
hcv: rmx uyk
vbz: puh lly
onj: ntl qme
qvq: tri vxj
elj: you ait
czj: twf oam
hmk: qci eai
cwr: rqt xgi vbf mfw
wts: fln coj ljb vep clu byi yxz kno cwg ida tmr arv dpg lox amj iqc inl opz tlw
kfg: jbo sss osx
xbo: vlm
qtz: wts kiv xpi iup
lli: qlf
def: jyv kiv wts iup xpi
nyp: xxd
tri: jyi
uym: nwo wzi kfo dbf ykf
eom: iup xpi jyv kiv wts
qci: wdm
sjx: dny uzy hkj
flo: cnn
vxj: wtr jyi
iwp: mfh emp
cnl: vja
irc: tmu def ywu
ptr: iup xpi kiv wts jyv
eai: pmw obu knl
jts: aci rmm
dqn: ohf bti
bit: onj
bjd: usk pwa sqf mqe
nkx: sjx xxd
xoe: vxj sid
wrb: sqf vhx mqe
wcq: wts kiv xpi
usk: qll
taj: xpi kiv
jeu: qll emp mfh
bgy: fdd pno
vti: ftt
tlw: ema mca
saz: ywt ucw yuo
iwt: gql icx
jzo: jlh dbl rzj gkj
dbl: sms hyv ikf kzs
whx: wzi ykf dbf
pwo: ojn vti bdt jrw
khf: rmm iqs
ame: rzf qlf dvq
mfh: ibr jdu dsi buz bkm mer lsw jne yqi pew tvh irq
vvx: ull eih bit
iqc: jbg vyb
kfo: pxm
